02010000000101010000
02000000000000000000
02000000000000000000
02010000000000000000
02010000000000000000
02010000000000000002
02000000000000000000
00000000000000000000
00000000000000000000
00000000000000000000
00000000000000000000
00000000000000000000
00000000000000000000
00000000000000000000
00000000000000000000
