00000000000000000000
00000000000000000000
00000002020002020000
00000001091205010000
00000000081204000000
00000202101206020200
00000101010001010100
00000000020202000000
00000000010101000000
00000000000000000000
00000000000000000000
00000000000000000000
00000000000000000000
00000000000000000000
00000000000000000000
